01111000011110
11111111111111
11111111111111
00111111111100
00001111110000
00000011000000