11100111100111
11111111111111
00100111100100
00220022002200
22233333333222
33300000000333