12222222222221
11222222222211
11122222222111
11112222221111
11111222211111
11111122111111